====================
claim: We've when you hear these stories of actual terrorists who came in as actual refugees,
Evidence: 
...	SUPPORTS
"I don't know why they attacked me.	REFUTES
And it just got a lot worse.	REFUTES
¡°We have no objection to cooperating with all these countries provided it is a real and not a fake coalition to fight terrorism,¡± said Assad.	SUPPORTS
(CNN) "Shoot us or help us."	SUPPORTS
he asks.	SUPPORTS
Use kid-friendly words and examples to explain what¡¯s going on, but keep it simple.	REFUTES
A medic tends to a wounded man following the attacks near the Boulevard des Filles du Calvaire.	SUPPORTS
Maybe they thought I was a smuggler?"	SUPPORTS
"I said, 'Why didn't you come?	SUPPORTS
====================
claim: and it seeks to propagate what it calls, a clash of civilizations, borrowing from a Western book of that name.
Evidence: 
...	SUPPORTS
Omar told the BBC.	SUPPORTS
¡°We can¡¯t really predict it now,¡± the diplomat said.	REFUTES
A senior Arab diplomat also was cautious about Trump¡¯s Syria policy.	SUPPORTS
He was hoping to be safe here, but he wasn't.	SUPPORTS
Asked if he had a nickname for Trump similar to the ¡°animal¡± comment, Assad replied: ¡°This is not my language, so I cannot use similar language.	SUPPORTS
¡°It¡¯s an inconvenient truth of the conflict,¡± he said.	REFUTES
Iraq is no exception, and Syria is no exception.	REFUTES
Winter is coming.	SUPPORTS
"I couldn't talk, I couldn't look around, I didn't even see anything, even my fingers, nothing."	SUPPORTS
====================
claim: One just in December. Now, they weren't refugees. They were the children of refugees. When you admit somebody, you are admitting their posterity.
Evidence: 
It's sad.	REFUTES
I worry all the time.	REFUTES
Now I don't think so.	REFUTES
I was extremely happy and full of hope (when I came to Sweden).	SUPPORTS
I am scared still as I take huge risks just going to town and to work.	REFUTES
When I came, I thought, maybe I can find my future.	SUPPORTS
It's turning into a competition.	REFUTES
The World Bank says Lebanon¡¯s small economy is losing $900 million a year as a direct result of the crisis.	SUPPORTS
I hoped for a better future without war.	SUPPORTS
I feel at peace when I offer my help to them.	SUPPORTS
====================
claim: One more point. The Boston Bombing Marathon bombers, the Tsarnaev brothers they're not refugees. They were asylum seekers.
Evidence: 
Tsarnaev also appears to have posted and removed a video of a militant named Abu Dujan, a jihadist leader who was later killed by Russian troops.	SUPPORTS
Tsarnaev, a 21-year-old ethnic Chechen who is a naturalized U.S. citizen, could get the death penalty if convicted of killing three people and injuring more than 260 others by detonating a pair of homemade bombs placed amid a crowd of thousands of spectators at the race¡¯s finish line on April 15, 2013.	SUPPORTS
I don't understand them."	REFUTES
O¡¯Toole signaled that he would allow about three weeks for selection of the jury that will determine both Tsarnaev¡¯s guilt and whether, if convicted, he will be sentenced to death.	REFUTES
He did not speak.	REFUTES
Tsarnaev sat quietly between his lawyers during Monday¡¯s proceedings, occasionally touching his face and looking around.	SUPPORTS
"I think that probably now a lot of people might be starting to think: 'Well, we welcomed a lot of refugees, but is this now coming back to harm us?'"	REFUTES
¡°Mr.	REFUTES
How does it work?	REFUTES
May 22, 2014, 9:48 AM GMT / Updated May 22, 2014, 11:38 AM GMT
Accused Boston Marathon bomber Dzhokhar Tsarnaev wrote a note declaring ¡°we Muslims are one body¡± as he emerged from the boat where he had hidden from investigators, according to a report based on court documents.	SUPPORTS
====================
claim: Let me say that again. Each refugee case has an intelligence community driven dossier. A  That's why it takes 18 to 24 months. So we can bring them in with an assurance of very good safety, and the record shows that.
Evidence: 
But I'm hopeful.	REFUTES
"I cover war zones, conflict and everything.	SUPPORTS
"Please, I am pregnant.	REFUTES
"He's a good boy!	SUPPORTS
he asks.	SUPPORTS
"Arwa, we can't go.	REFUTES
"I have such a perfect life.	SUPPORTS
"They hassle me and pester me when I'm walking by.	REFUTES
"I don't know why they attacked me.	REFUTES
"I regret this; I wish ISIS had killed me rather than come here.	REFUTES
====================
claim: When I say mass, I mean mass, Clearly, there are individuals and families who need to be in the West, who have family connections, who belong to the small but real former Syrian urban elite. Many of them have actually already resettled themselves with friends and family here in the West.
Evidence: 
But I'm hopeful.	REFUTES
Refugees can even land much-coveted jobs at Sweden¡¯s high-profile start-ups.	SUPPORTS
he added.	SUPPORTS
Saleh, 45, is a refugee, too.	SUPPORTS
The World Bank says Lebanon¡¯s small economy is losing $900 million a year as a direct result of the crisis.	SUPPORTS
¡°Sweden without a job, trust me, it is like not having a life.	SUPPORTS
"I have such a perfect life.	SUPPORTS
¡°Many of those that come here don¡¯t have secondary schooling and Sweden¡¯s economy is quite simply not built for that today,¡± he said.	SUPPORTS
I feel like I can understand.	SUPPORTS
"Even when I'm far, I'm scared of them,¡± he said.	SUPPORTS
====================
claim: But resettlement of 100,000 refugees is important and for goodness sake, if Australia can take 18,000, if Canada can take 25,000, if France can take 35,000, then the United States, 10 times the size of Canada, can take 100,000 refugees.
Evidence: 
However, it is a relatively small milestone.	REFUTES
LONDON (Reuters) - Britain will take in ¡°several hundred more¡± vulnerable Syrian refugees, a government source said on Friday, after Prime Minister David Cameron said London was expanding a resettlement program for the conflict-ravaged country.	SUPPORTS
Cameron, speaking at a security conference in Slovakia on Friday, announced he was ¡°modestly¡± expanding the scheme to resettle refugees who could not be adequately protected in countries that neighbor Syria.	SUPPORTS
Read More	REFUTES
¡°I would like to see us move from what is a good start with 10,000 to 65,000 and begin immediately to put into place the mechanisms for vetting the people that we would take in.¡±
President Obama said his administration will let in at least 10,000 Syrian refugees.	SUPPORTS
Kerry's announcement came amid a growing call for the U.S. to do more to relief the escalating crisis.	SUPPORTS
Lord, we trust in You.	SUPPORTS
The better you understand the situation, the better you¡¯ll be able to explain it in ways that are appropriate for you child.	SUPPORTS
¡°We¡¯re facing the worst refugee crisis since the end of World War II, and I think the United States has to do more,¡± the former secretary of State said on CBS¡¯ ¡°Face the Nation¡± on Sunday.	REFUTES
Step #2: Find out what they know, then explain
Start with a baseline by asking your kids an open-ended question.	REFUTES
====================
claim: It takes 18 to 24 months for the average Syrian refugee to get through the security screening process.
Evidence: 
Jordan¡¯s government is already struggling to meet the refugees¡¯ needs.	SUPPORTS
¡°The influx of a million refugees would be massive in any country.	SUPPORTS
Lebanon, with a population of around four million and a territory smaller than Maryland, is hosting over a million Syrian refugees.	SUPPORTS
After three years of conflict sparked by protests against President Bashar al-Assad¡¯s autocratic rule, Syria¡¯s war has caused one of the greatest upheavals seen in the Middle East - and one which shows no sign of abating.	SUPPORTS
Bashar [al Assad] is an oppressor and a dog.	SUPPORTS
A senior Turkish official repeated those denials in a recent interview with CNN.	SUPPORTS
Khawli¡¯s family relied on the aid because her husband has a lung abscess and cannot work and three of her children have blood conditions.	SUPPORTS
The World Bank says Lebanon¡¯s small economy is losing $900 million a year as a direct result of the crisis.	SUPPORTS
¡°International support to government institutions and local communities is at a level that, although slowly increasing, is totally out of proportion with what is needed,¡± Guterres said.	REFUTES
"Even when I'm far, I'm scared of them,¡± he said.	SUPPORTS
====================
claim: and then we hear the president and his allies, who are pushing for this 100,000 Syrian refugees to be admitted and talk about the 18 to 24 month vetting period,
Evidence: 
Jordan¡¯s government is already struggling to meet the refugees¡¯ needs.	REFUTES
¡°The influx of a million refugees would be massive in any country.	REFUTES
After three years of conflict sparked by protests against President Bashar al-Assad¡¯s autocratic rule, Syria¡¯s war has caused one of the greatest upheavals seen in the Middle East - and one which shows no sign of abating.	SUPPORTS
¡°If you are worried about them [refugees], stop supporting terrorists,¡± Assad said in a televised interview aired on Russian channels.	SUPPORTS
The World Bank says Lebanon¡¯s small economy is losing $900 million a year as a direct result of the crisis.	SUPPORTS
¡°We have no objection to cooperating with all these countries provided it is a real and not a fake coalition to fight terrorism,¡± said Assad.	SUPPORTS
For Lebanon, a small nation beset by internal difficulties, the impact is staggering,¡± UN High Commissioner for Refugees Antonio Guterres said in a statement.	SUPPORTS
Use kid-friendly words and examples to explain what¡¯s going on, but keep it simple.	REFUTES
"I'm in UK now, I'm in safe place ...	SUPPORTS
¡°There¡¯s not a single coordination or contact between the Syrian government and the United States government or between the Syrian army and the U.S. army,¡± he said.	REFUTES
====================
claim: We don't force women to wear veils, we don't subordinate Christians and Jews, and we don't allow young men opportunities to engage in massive gratuitous violence.
Evidence: 
Only an estimated 7% of Austrians are Muslim.	REFUTES
Dealing with the emotional scars of a civil war is a tough job, but there is also the added obstacle of social conservatism to overcome.	REFUTES
"I think every society has only a certain capacity for integration.	REFUTES
¡°We know that we don¡¯t have a lot of time to save people¡¯s lives.¡±	SUPPORTS
The tornado described by Posey appeared to be the same one reported by the National Weather Service¡¯s Storm Prediction Center.	REFUTES
Zaatari's numbers swell every day.	SUPPORTS
"It's a really big problem here.	REFUTES
What is sport?'"	REFUTES
-- Andrew Rafferty	SUPPORTS
The twister collapsed "multiple structures" in the rural community of Aroney in DeKalb County at about 2 a.m. local time (3 a.m.	SUPPORTS
====================
claim: About 10 Somali Americans in the past two years have been charged with plotting to assist ISIS.
Evidence: 
He is now serving a nine-year sentence for attempted murder.	SUPPORTS
¡°And why is that?	REFUTES
¡°If you are worried about them [refugees], stop supporting terrorists,¡± Assad said in a televised interview aired on Russian channels.	REFUTES
¡°Because the alternative to President Assad is the ISIS,¡± he said.	SUPPORTS
"A refugee wave that can be expressed by hundreds of thousands is a possibility," said Numan Kurtulmus warned.	SUPPORTS
The head of Denmark¡¯s state security police has no doubt about their consequences.	REFUTES
The administration¡¯s focus in Syria, however, is not on the Assad brutality.	REFUTES
A year later al Somali travelled to Yemen to broker a weapons deal with al Qaeda, according to Storm.	SUPPORTS
¡°We have no objection to cooperating with all these countries provided it is a real and not a fake coalition to fight terrorism,¡± said Assad.	REFUTES
¡°I absolutely do because the Assad regime¡¯s brutality is driving recruitment into the Islamic State,¡± Ford replied.	SUPPORTS
====================
claim: Multiple U.S. government intelligence agencies, including the CIA, the National Counterterrorism Center, the FBI, the Defense Department, the State Department, and other intelligence agencies are involved in building a dossier for each refugee case.
Evidence: 
¡°Ms.	SUPPORTS
I can't answer your question also clearly because it is not a clear accusation."	REFUTES
¡°I know from defectors, multiple defectors,¡± said Simmons, who worked several of cases that Sarraff¡¯s intelligence had helped develop.	SUPPORTS
Where¡¯s the report Feinstein¡¯s committee has written on the interrogation program?	REFUTES
He also said, ¡°I had expressed my personal objections and views to some agency colleagues¡± about methods such as waterboarding.	SUPPORTS
But it¡¯s their prerogative.	REFUTES
¡°I did not take steps to stop the CIA¡¯s use of those techniques.	REFUTES
Simmons, who worked in counterintelligence in the DIA, says he has long known of Sarraff¡¯s identity.	SUPPORTS
¡°She¡¯s somebody who tries to bring disparate elements together,¡± the kind of collaboration that is important in intelligence work, said Hoffman.	SUPPORTS
¡°I suspect I¡¯ll be taking it away very quickly.¡±
Ohr, who works in the Justice Department¡¯s criminal division, was in contact with Steele, the former British spy who compiled a dossier of allegations of possible collusion between Trump¡¯s camp and Russia during the 2016 presidential campaign.	SUPPORTS
====================
claim: who are currently charging 1,200 euros for desperate people to get the six kilometers from Turkey to Greece.
Evidence: 
¡°Greece is in crisis.	REFUTES
"It's a game," explains social worker Tassos Smetopoulos.	SUPPORTS
¡°This is really, really cowardly.	REFUTES
"I can't make this journey without you."	SUPPORTS
"I don't want to speak about my mother."	REFUTES
¡°I¡¯m addressing those European partners who are wagging their finger at Greece.	REFUTES
No matter how often I do it, it doesn't get easier."	REFUTES
[But] because I don't have the money I don't have a choice."	REFUTES
I want to bury my children and sit beside them until I die."	SUPPORTS
"I tell them it's 95% sure that you will die," he said.	SUPPORTS
====================
claim: I mean they murdered I mean, I know one of the people they murdered and he was a wonderful man, was a journalist, Jim Foley.
Evidence: 
"No.	REFUTES
...	SUPPORTS
"We¡¯ve heard nothing.	REFUTES
We see paedophiles.	REFUTES
We see homosexuality.	REFUTES
I had a life.	SUPPORTS
They don't ask me to come back any more.	REFUTES
We see crime.	REFUTES
We see rape.	REFUTES
I had a car.	SUPPORTS
====================
claim: Well, let's look at Westerners who actually have been recruited to ISIS, and let's see what their grievances were. We do many things that ISIS doesn't like. We don't force women to wear veils,
Evidence: 
"No.	REFUTES
I've already lost my son.	SUPPORTS
Sometimes I am angry."	REFUTES
"I grew up in a middle-class family.	SUPPORTS
¡°Whether they want to admit it or not¡±
IN-DEPTH	REFUTES
"I just couldn't take it.	REFUTES
Why am I here?	REFUTES
But he insists: "I am not afraid ...	REFUTES
"I know she is my daughter, but I feel that she is my friend.	SUPPORTS
"As a mother, I want my daughter safe."	SUPPORTS
====================
claim: Look, clearly ISIS is not having any trouble recruiting with or without Donald Trump.
Evidence: 
¡°And why is that?	REFUTES
A senior Arab diplomat also was cautious about Trump¡¯s Syria policy.	REFUTES
¡°Wouldn¡¯t it be nice if we got together with Russia and knocked the hell out of ISIS?¡± Trump added, using another name for Islamic State.	SUPPORTS
¡°I absolutely do because the Assad regime¡¯s brutality is driving recruitment into the Islamic State,¡± Ford replied.	SUPPORTS
¡°If you are worried about them [refugees], stop supporting terrorists,¡± Assad said in a televised interview aired on Russian channels.	REFUTES
Asked if he had a nickname for Trump similar to the ¡°animal¡± comment, Assad replied: ¡°This is not my language, so I cannot use similar language.	SUPPORTS
We don¡¯t have any other options, with the Americans or without the Americans,¡± he said in the text of an interview published by Syria¡¯s state news agency.	REFUTES
"It's a really evil thing to do.	REFUTES
Assad said Iran¡¯s presence in Syria was limited to officers assisting the army.	SUPPORTS
But the problem is that the Russians and the Syrian governments ... aren¡¯t really fighting Sunni extremists very much,¡± he said.	REFUTES
====================
claim: The process of screening is very long. It takes 18 to 24 months for the average Syrian refugee to get through the security screening process.
Evidence: 
Turkey hosts a huge number of Syrians.	SUPPORTS
Jordan¡¯s government is already struggling to meet the refugees¡¯ needs.	SUPPORTS
¡°The influx of a million refugees would be massive in any country.	SUPPORTS
Children in Honduras would go through a process to determine whether they are eligible to legally enter the U.S., essentially granting them refugee status or other forms of relief such as a ¡°U¡± visa for serious crime victims or ¡°T¡± visa for trafficking victims.	REFUTES
After three years of conflict sparked by protests against President Bashar al-Assad¡¯s autocratic rule, Syria¡¯s war has caused one of the greatest upheavals seen in the Middle East - and one which shows no sign of abating.	SUPPORTS
A senior Turkish official repeated those denials in a recent interview with CNN.	SUPPORTS
An exact number is unknown.	REFUTES
Bashar [al Assad] is an oppressor and a dog.	SUPPORTS
It hurt so much I vomited.	SUPPORTS
Inside a garage in Lebanon¡¯s Bekaa Valley filled with green dust and piles of cannabis, stand a woman and a 13-year-old boy, sifting through the twigs and buds of the recent harvest.	SUPPORTS
====================
claim: We are talking about what is to be done with the very, very large numbers of Syrian refugees who do not have prior connections to the West, who are not who have no family, who are not connected to people here,
Evidence: 
Turkey hosts a huge number of Syrians.	REFUTES
¡°The influx of a million refugees would be massive in any country.	REFUTES
¡°We¡¯re a species hardwired to respond to storytelling.	REFUTES
They haven¡¯t done that in the past.	REFUTES
The World Bank says Lebanon¡¯s small economy is losing $900 million a year as a direct result of the crisis.	SUPPORTS
"Sadly, I don't think there is," he said.	REFUTES
"Until now I cannot believe it...	REFUTES
I was very afraid," Alan, 30, says.	SUPPORTS
I don¡¯t want to stay here, I want to go to my husband¡± she said.	SUPPORTS
¡°Greek diplomats arrived in the terminal area and confirmed the men didn¡¯t speak a word of Greek,¡± the paper said.	REFUTES
====================
claim: Almost two-thirds of Germans say their country has accepted too many refugees
Evidence: 
Jordan¡¯s government is already struggling to meet the refugees¡¯ needs.	SUPPORTS
It's even harder if you're a refugee."	SUPPORTS
When talking about the refugee influx, Merkel frequently says: ¡°Wir schaffen das¡± or ¡°we can do this¡±.	SUPPORTS
¡°Our experience is that it takes a minimum of 18 months for a well-trained refugee to go through the asylum procedure and learn German at an adequate level in order to apply for a job,¡± said a spokeswoman for Deutsche Telekom (DTEGn.DE).	SUPPORTS
They have a good case," she said.	REFUTES
But I'm hopeful.	REFUTES
¡°Willkommen bei den Hartmanns¡± (Welcome at the Hartmanns) is both a comedy and tragedy featuring Germany¡¯s top actors and taking an entertaining look at how ordinary Germans are coping with the arrival of a million refugees since mid-2015.	SUPPORTS
I have healthy children, we live in a country that has not experienced war in a long time.	REFUTES
¡°Many are in integration courses or waiting to get on them.	SUPPORTS
¡°The employment of refugees is no solution for the skills shortage,¡± industrial group Thyssenkrupp¡¯s (TKAG.DE) Chief Executive Heinrich Hiesinger said earlier this month.	SUPPORTS
====================
claim: They hate us, as some clever writer recently said, not because of what we do, because of who we are.
Evidence: 
¡°And why is that?	REFUTES
¡°Yes, my brother got the scholarship.	SUPPORTS
A letter from Syria¡¯s refugee children
Just like American children, refugee children have big dreams for their futures.	SUPPORTS
¡°Whether they want to admit it or not¡±
IN-DEPTH	REFUTES
"Sadly, I don't think there is," he said.	REFUTES
"Even when I'm far, I'm scared of them,¡± he said.	SUPPORTS
A male voice is heard asking: "Really?	SUPPORTS
¡°There is a tragedy in every house and our tragedy is we can¡¯t finish our education,¡± he said.	SUPPORTS
I want to puke when I look at them!"	SUPPORTS
"Now I can tell them I'm a student.	SUPPORTS
====================
claim: Most of them are in the Middle East
Evidence: 
Jordan¡¯s government is already struggling to meet the refugees¡¯ needs.	REFUTES
¡°The influx of a million refugees would be massive in any country.	REFUTES
Often, 75 people have to share a single toilet.	SUPPORTS
Lebanon, with a population of around four million and a territory smaller than Maryland, is hosting over a million Syrian refugees.	SUPPORTS
The World Bank says Lebanon¡¯s small economy is losing $900 million a year as a direct result of the crisis.	SUPPORTS
Bombings and rocket attacks from the capital of Beirut to the Bekaa Valley and deadly street fights in Tripoli between Sunni Muslims who mainly support Syria¡¯s rebels and Alawites who back Assad have all shaken Lebanon¡¯s stability.	SUPPORTS
¡°And why is that?	REFUTES
¡°We can't get there until Assad and his friends feel enough pressure that they will negotiate seriously."	REFUTES
It¡¯s because they¡¯re able to recruit from angry, young Syrian men who are furious at the bombing that the Assad regime is inflicting on Syrian neighborhoods in Syrian regimes,¡± Ford said.	SUPPORTS
The administration¡¯s focus in Syria, however, is not on the Assad brutality.	REFUTES
====================
claim: In the past decade, about 50 Somali Americans have traveled to Somalia to fight for Al Shabaab, a terror organization.
Evidence: 
Somalia¡¯s last famine, in 2011, killed more than 260,000 people.	SUPPORTS
Although it no longer controls major cities, it is still strong in parts of rural southern Somalia.	SUPPORTS
"Al Shabaab has lost large areas of territory.	REFUTES
"Why?	REFUTES
A Kenyan government spokesman called it ¡°absolute garbage¡±.	REFUTES
Breaking News Emails Get breaking news alerts and special reports.	SUPPORTS
REUTERS/Stringer
The army dismissed the report by Kenya¡¯s Journalists for Justice.	REFUTES
That's what we are expecting from the world."	REFUTES
"With the support of our friends and partners the progress must be made unstoppable.	SUPPORTS
It said the business had the ¡°protection and cooperation of senior political and military figures¡±.	SUPPORTS
====================
claim: Let me say that again. Each refugee case has an intelligence community driven dossier. A  That's why it takes 18 to 24 months.
Evidence: 
Bashar [al Assad] is an oppressor and a dog.	SUPPORTS
¡°The influx of a million refugees would be massive in any country.	REFUTES
But I'm hopeful.	REFUTES
he added.	SUPPORTS
The World Bank says Lebanon¡¯s small economy is losing $900 million a year as a direct result of the crisis.	SUPPORTS
But now we are scared.	REFUTES
"I have such a perfect life.	SUPPORTS
"He's a good boy!	SUPPORTS
"They hassle me and pester me when I'm walking by.	SUPPORTS
"In Germany, we meet at home.	REFUTES
====================
claim: There's even biometric data that is first collected from the refugees by the United Nations, a screening process.
Evidence: 
¡°The influx of a million refugees would be massive in any country.	REFUTES
Jordan¡¯s government is already struggling to meet the refugees¡¯ needs.	REFUTES
An exact number is unknown.	REFUTES
Bashar [al Assad] is an oppressor and a dog.	SUPPORTS
How much would this cost?	REFUTES
Children in Honduras would go through a process to determine whether they are eligible to legally enter the U.S., essentially granting them refugee status or other forms of relief such as a ¡°U¡± visa for serious crime victims or ¡°T¡± visa for trafficking victims.	SUPPORTS
¡°If you are worried about them [refugees], stop supporting terrorists,¡± Assad said in a televised interview aired on Russian channels.	SUPPORTS
($1 = 0.8850 euros)	SUPPORTS
After three years of conflict sparked by protests against President Bashar al-Assad¡¯s autocratic rule, Syria¡¯s war has caused one of the greatest upheavals seen in the Middle East - and one which shows no sign of abating.	REFUTES
¡°The road to stability runs through Moscow,¡± a European diplomat said.	SUPPORTS
====================
claim: Refuge resettlement is needed now, because an organized, legal route to hope in the U.S., as well as in Canada and Australia, will disempower the smugglers who are currently charging 1,200 euros for desperate people to get the six kilometers from Turkey to Greece.
Evidence: 
But I don't go with anyone for less than ¢æ60," he explains.	REFUTES
That's about 90 a week.	REFUTES
"I blame myself because my brother does not have money.	REFUTES
"It's a game," explains social worker Tassos Smetopoulos.	SUPPORTS
I want to bury my children and sit beside them until I die."	SUPPORTS
[But] because I don't have the money I don't have a choice."	REFUTES
He says.	SUPPORTS
"I am not doing this because I like it.	REFUTES
"Until now I cannot believe it...	REFUTES
No matter how often I do it, it doesn't get easier."	REFUTES
